Device,Room,Bootstrap,WiFi Config,MIDI Connection,OSC Configuration,Wifi+OSC,Tot
Bridge,1,14,194,14,41,235,263
Bridge,2,19,209,10,17,226,255
Bridge,1,50,198,180,247,445,675
Bridge,2,30,60,9,19,79,118
Bridge,1,36,184,25,43,227,288
Bridge,2,40,38,5,26,64,109
Bridge,1,43,174,9,50,224,276
Bridge,2,49,118,13,11,129,191
Bridge,1,43,103,11,42,145,199
Bridge,2,24,60,10,23,83,117